bbbbbbbbbbbbbbb
xH000000000xx0x
x0x0xxx0xx0000x
x0x0x0xx0xxxx0x
x00000x0000000x
x00xx0xx00x0xxx
xx000000000000x
xx0x0xxx0xxxx0x
x000000x0xxxx0x
xx0xxx00000000x
x0000x0xx0xxx0x
x0xx0x0xx0xxx0x
x0xx0000000xx0x
x0000xxxxx000Gx
xxxxxxxxxxxxxxx
